################################################################################################################################################################################################
#########################################################         ######                        #########                     #############################################         ############
######               ############            ############         ######                        #########                     #############################################         ###   ######
######               ############                                 ######                        #########                     #############################################         ###   ######
######               ############            ############         ######                                                      ################################################   ######   ######
######               ###############   ##################         ######                        #########                     ######            ##############################   ######   ######
############      ##################   #################################                        #########                     ######            ############         #########   ######   ######
############      ##################   #################################                        #########                     ######                                 #########   ######   ######
############      ###############         #########         ############                        #########                     ######            ############         #########   ######   ######
############      ###############                           ############                        #####################      ####################################   ############               ###
############      ###############         #########         ##################   #########   ########################      ####################################                              ###
###               ##################   ############         ##################   #########   #####################            ###########################            #########               ###
###               ##################   ###############   ###############               ###   #####################            ###########################            #########               ###
###               ##################   ###############   ###############                                                                              ###            #########               ###
###               ##################   ###############   ###############                                                      ######                                 #########   ###############
###               ##################         ######               ######               ###########################            ######         ######   ###            #########   ###############
######                                                            ###################################################      ########################   ########################   ###############
######   ######   ##################         ######               ###################################################      ########################   ########################   ###############
######   ######   ##################         ######               ######                  ######         #########         ########################   ########################   ###############
######   ######   ######################################################                  ######         #########         #####################               #########                  ######
######   ######   ######################################################                                                   #####################               #########                  ######
######   ######   ##################         ######               ######                  ######         #########         #####################                                          ######
###                  ###############                              ##############################         ############   ########################               #########                  ######
###                                          ######               ###################################################   ########################################################################
###                  ###############         ######               ###################################################   ########################################################################
######   ###############################################################                                                      ##################################################################
######   ###############################################################                                                      ######            ##################            ##################
######   ###############################################################                                                      ######                                          ##################
######   ###############################################################                                                      ######            ##################            ##################
######   #####################            ##############################                                                                        ##################            ##################
######         ###############            ############         #########                                                      ######            ##################            ##################
######         ###############                                 #########                                                      ######            ##################            ##################
######         ########################   ############         #########                                                      ######            #####################   ########################
######         ########################   ##################   #########                                                      ############   ########################   ########################
######   ###   ########################   ##################   #########                                                      ############   ########################   ########################
######   ###   ########################   ##################   #########                                                      ############   ########################   ########################
######   ###   #####################         #########            ######                                                      #########                     #########   ########################
###                  ###############         #########            ######                                                      #########                                                   ######
###                                                               ######                                                      #########                     #########   ###############   ######
###                  ###############         #########            ######                                                      #######################################                        ###
######   ###############################################################                                                      #######################################                        ###
######   ##########################################################################################   ###############################################################                        ###
###         ##################               ######            ####################################   ##########################################                                             ###
###                                                            #########         ############            #########         ##########################################                        ###
###         ##################                                 #########                                                   ##########################################                        ###
######   #####################               ###########################         ############            #########         ##########################################   ###   ##################
######   ###############################################################         ############            ############   #############################################   ###   ##################
######   ############################################################################################################   ###############               ###############                        ###
###                     ######         #########            #########################################################   ###############                                                      ###
###                     ######            ######            ############            ######               ############   ###############                                                      ###
###                     ######                                 #########            ######                              ###############               ###############                        ###
###                     ######            ##################   #########            ######                              ########################   ##################                        ###
###                     ###############   ##################   #########            ###########################         ########################   ##################                        ###
###                     ###############   ##################   #########            ###########################   ##############################   ##################                        ###
######   ##############################   ##################   ############      ##############################   ###########################         ########################   ###   #########
######   #####################               ###############   ############      ##############################   ###########################         ########################   ###############
######   #####################               ############         #########      #########            ######         ########################         ########################   ###############
######   #####################               ############         #########         ######            ######         ########################         ########################   ###############
###         ##################                                    #########         ######            ######         ########################         ########################   ###############
###         ##################               ############         #########                                          #############################################                     #########
###                                                                                                                  #############################################                     #########
###         ##################               ############         #########         ######            ######         #############################################                     #########
###########################################################################         ############################################################################################################
################################################################################################################################################################################################
