################################################################################################################################################################################################
############################################################            ########################                  #####################         #################################            ###
###                              ###########################               ###         #########                  #####################                                                      ###
###                              ###########################               ###         #########                  #####################                                    ######            ###
###                              ######         ############                           ########################   #####################   ##################               #####################
###                              ######         ############               ###         ########################   #####################   ######################################################
###                              ######         ###############   ######   ######   ###########################   #####################   ######################################################
#########   ############   ###############      ###############   ######   ######   ###########################   ###############            ######                  ######               ######
#########   ############   ###############      #########                  ###            ############                                                               ######               ######
#########   ############   ###############      #########                                 ############                  #########                                    ######               ######
######                           #########         ######                  ###                                          #########            ######                  ######               ######
######                                             ######                  ###########################                  #########                                                         ######
######                           #########         ############   ######   ######################################################            ######                  ######               ######
######                           #########   ##################   ######   ######################################################            ##############################               ######
##########################################   ##################   ######   ############################################################   #################################               ######
##########################################   ############            ###   ############################################################   #################################               ######
####################################               ######            ###   ############   #############################################   ##################         ######               ######
####################################               ######            ###   ############   #############################################   ##################         ###############   #########
###                        #########               ######            ###   ######                  #################################         ###############         ###############   #########
###                        #########               ######            ###   ######                  #########               #########         ###############         #########            ######
###                        #########               ######                                                                  #########                                 #########            ######
###                        #########               ######            ###   ######                  #########               #########         ###############         #########            ######
###                                                                                                                        #########         ###############         #########            ######
###                        ######                  #####################   ######                  #########               #########         ###############         #########            ######
###                                                #####################   #####################################################################################################################
#########   #####################                  #####################   #####################################################################################################################
#########   #####################   ######   ###############         ###   ############################################################                                                      ###
#########   #####################   ######   ###############         ###   ########################         ###########################                                                      ###
###            ##################   ###         ############         ###   ########################         #########            ######                                                      ###
###            ##################   ###         ############         ###   ########################                                                                                          ###
###                                             ############         ###   ##################                                    ######                                                      ###
###            ##################   ###         ############         ###   ##################   ######   ############            ######                                                      ###
###            ##################   ########################         ###   ##################   ######   ##############################                                                      ###
#########   #####################   ########################         ###   ##################   ######   ##############################                                                      ###
#########   #####################   ########################         ###   ##################   ######   ##############################                                                      ###
###            ##################   ###########################   ######   ############            ###   ##############################                                                      ###
###            ###############               ##################   ######   ############            ###   ######                  ######                                                      ###
###            ###############               ##################   ######   ############            ###   ######                  ######                                                      ###
###            ###############               ##################   ######   ############            ###   ######                  ######                                                      ###
###            #####################   ########################   ######   ############                                          ######                                                      ###
#########   ########################   ########################               #########            ###   ######                  ######                                                      ###
#########   ########################   ########################               #########               #########                  ######                                                      ###
######         ############               #####################               #########            ############                  ######                                                      ###
######                                    #####################               #########            ############                  ######                                                      ###
######         ############               #####################               ###############   ################################################################################################
#########   ###############               #####################               ###############   ################################################################################################
#########   ###################################################               ###############   ################################################################################################
#########   ######################################################   ###   ##################         ###################################################         ###############         ######
###                        #######################################                                                                                                                        ######
###                        ####################################                  ############         ######                                                      ###############         ######
###                        ####################################                  ############         ######            #########                           #####################         ######
###                        ####################################                                       #########   ###############            #######################################   #########
###                        ####################################                  ############         #########   #####################   ##########################################   #########
###                        #########         ##################                  ############         #########   #####################   ##########################################   #########
############                                 #####################   ######   ###############         #########   #####################   ##########################################   #########
############      ##################         #####################   ######   ###############         ######            ######                                    ###############         ######
############      #####################   ########################   ######   ###############   ############            ######                                    ###############         ######
######                     ############   ###############                     ###############   ############            ######                                                            ######
######                     ############   ###############                     ############         #########            ######                                    ###############         ######
######                     #########            #########                     ############         #########            ######                                    ###############         ######
######                     #########            ##########################################                                                                        ###############         ######
######                     #########            ##########################################         ##############################################################################         ######
################################################################################################################################################################################################
################################################################################################################################################################################################
