################################################################################################################################################################################################
########################                  ###############         #########         #########               ################################################         ###########################
######            ######                  ###############                           #########                           ##################            ######         ###########################
######                                    ###############         #########         #########               ######            ############            ######         ###########################
######            ######                  ###############         #########         #########               ######            ############                                                ######
############   #############################################   ##############################               ######            ############            ######                              ######
############   #############################################   ##############################               ##############################            ######         ############         ######
############   ############               ######               #########               ############      ###########################################################################   #########
######               ######                                                            ############      ###########################################################################   #########
######                                    ######                                       ############      ###########################################################################   #########
######               ######               ######               #########               ############      ###########################################################################   #########
############                              #########   ######   ####################################      #########         #########################################################   #########
############   ############               #########   ######   ####################################      #########         ###############            #####################            #########
############   ####################################   ######   ##############################                              ###############            #####################            #########
############   ####################################   ######   ##############################               ######         ###############            #####################            #########
############   #################################                                                            ######         ###############                                             #########
############   #################################               ##############################               ######         ###############   ###   ########################            #########
############   #################################               ###                     ######               ######         ###############   ###   ########################            #########
###                     ########################               ###                     ############   #################################                  ##################   ######   #########
###                     #########         ######                                       ############   #################################                  ##################   ######   #########
###                     #########         ######               ###                     ############   #################################                  ##################   ######   #########
###                     #########         ##################   ############   ###############         #################################                  ##################   ######   #########
##################                        ##################   ############   ###############                           ###############   ######   #####################               #########
#################################         ############            ######               ######         ###############   ###############   ######   #####################               #########
#################################         ############                                 ######         #########            ############   ######   ##################                  #########
######################################################            ######               #########      #########            #########         ###   #####################               #########
######################################################            ######               #########      #########            #########         ###   ########################   ######   #########
############################################################   #################################      ##############################         ###   ########################   ######   #########
############################################################   #################################      ##########################################   ########################   ######   #########
############################################################   ##############################               ######            ##################   ########################   ######   #########
######               ############            ###############   ##############################               ######            ##################   ########################   ######   #########
######               ############            ###############   ##############################                                 ##################   ###               ######   ######   #########
######                                       ###############   ##############################               ######            ######                                 ######   ######   #########
######                                                            ###########################                                 ######         ###   ###               ######   ###         ######
######               ############            ###############      ###########################               ######            ######         ###   ########################   ###         ######
######               ####################################                  ##################               ######            ######         ###                                          ######
######               ###############                                       #######################################            ######         ##############################   ###         ######
######               ####################################                  #######################################            #############################################   ######   #########
############################################################   ######################################################   ###################################################   ######   #########
############################################################   ######################################################   ############               ############               ######         ###
###                                             ############   #################################         #########            ######                                                         ###
###                                                                                                      #########            ######                                                         ###
###                                             ######                                                                        ######               ############            ######      #########
###                                             ######                                                                                                                                 #########
###                                             ######               #####################   ###         #########            ###################################################      #########
###                                             ##################   #####################   ########################   ####################################            #########      #########
###                                             ##################   #####################   ########################   ############                  ######            #########      #########
###                                             ##################   #####################   #####################            ######                  ######            #########            ###
###                                                                                                                           ######                  ######            #########            ###
###                                             ##################   #########                                                ######                                    #########            ###
###                                             #########            #########                     ##################   ############                  ######            #########            ###
###                                             #########            ################################################   ############                  ######            #########            ###
###                                             #########            ################################################   ############                  ######            #########            ###
##############################   ######   ##################   ###   ################################################   ############                  ######            #########            ###
##############################   ######   ##################   ###   ############            #########                     ####################################   ###############   ###   ######
##############################   ######   ##################   ###   ############            ######                        ####################################   ###############   ###   ######
###                  ######                  ###############   ###   ############                                          #################################         ############   ###   ######
###                                          ###############   ###   ############            #########                     ###############   ###############         #########               ###
###                  ######                  ###############   ###   ############            #########                     ############         ############         #########               ###
###########################                  ############               #########            #########                     ############                                                      ###
###########################                  ############               #########            #########                     ############         ############         #########               ###
###########################                  ############               #########            ###############################################################         #########               ###
###########################                  ############               ######################################################################################################               ###
################################################################################################################################################################################################
