################################################################################################################################################################################################
############################################################         #############################################         ######               #################################         ######
############################################################         ############            ##################            ######               #################################         ######
#########         ##################         ############                                    ##################            ######                  ###               ############         ######
#########                                    ############            #########               ##################            ######                  ###               ############         ######
#########         ##################         ############            #########   ##############################            ######                  ###               ###############   #########
#########         #####################   ###############   ##################   ##############################   ###############                  ###               ###############   #########
############   ########################   ###############   ##################   ##############################   ###############                                    ###############   #########
############   ########################         #########   ##################   ##############################   ###############                  ###               ###############   #########
######            #####################         #########   ##################   ###########################         ###########################   ###############   ############         ######
######            #####################         #########   ##################               ###############         #####################                                                ######
######            #####################         #########   ##################               ###############         #####################            #########         #########         ######
############   #######################################         ###############               ###############         #####################                                                ######
############   #######################################         ###############               ###############      ########################            #########         ########################
############   #######################################                                       ###############      ########################            #########         ########################
############   #####################            ######         ###############               ######                     ##################   ###################################################
############   #####################            ########################                                                ##################   ###################################################
############   #########   #########            ############                                                            ##################   ###################################################
############   ###            ######            #########         #########               #########                     ##################   #####################                        ######
############                                                                                                            ############                        ######                        ######
##################                              #########         #########                                                                                                               ######
##################            ######            ###########################               #########                     ############                        ######                        ######
####################################            ##################################################################   ###########################################################################
##################################################################################################################   ###########################################################################
##################################################################################################################   ###########################################################################
###                                                      ######                  #################################            ############         ##############################         ######
###                                                      ######                  #########            ############                                                         ######         ######
###                                                                              #########                                    ############         #########               ######         ######
###                                                      ######                  #########            ############            ##############################               ######         ######
###                                                      ##################   #################################################################################   ###############         ######
###                                                      ##################   #################################################################################   ###############         ######
###                                                      ##################   #################################               ############               ######   ##################      ######
###                                                      ##################   ###############         #########                                          ######            #########      ######
###                                                      #########               ############         #########               ############               ######            #########         ###
###                                                      #########               ############                                                            ######            #########         ###
###                                                      #########               ############         #########               #####################   #########            #########         ###
###                                                      #########                              ###################################################   #########   ###   ############         ###
###                                                      #########               ##################################################################   #########   ###   ############      ######
###                                                      #########               #########                        #########         ############         ######            #########      ######
######   #################################################################################                        #########                              ######            #########      ######
######   #################################################################################                        #########                                                ######            ###
###         ##############################################################################                        #########         #########            ######            ######            ###
###         #########                     ##################                                                                                                                                 ###
###         #########                     ##################                  ############                        ######            ############         ######            ######            ###
###         #########                     ##################                  ############                        ######   ########################   #########            ############   ######
###         ########################   ##################                     ############                        ######   ########################   #########            ############   ######
######   ###########################   ##################                     ############                        ######   ########################   #########      ###############         ###
######   ###########################   ##################                     ############                        ######   ###############               ######      ###############         ###
###         ########################   ##################   ############################################################   ###############               ######      ###############         ###
###         ########################   ##################   ############################################################   ###############               ######      ###############         ###
###         ########################   ###############                              ##############################                  ######               ######      ##################   ######
###                                          #########                              ######               #########                  ######               ######            ############   ######
###         ############                                                            ######               #########                  ######               ######            ############   ######
########################                     #########                              ######                                                                                 ############   ######
############################################################   ###########################                                          ###########################            ############   ######
############################################################   ###########################               #########                  ###########################            ######         ######
############################################################   ###            ##################   ############################################################   ###############         ######
############################################################   ###            ##################   ############################################################   ###############         ######
###                  #######################################   ###            ###############         #########            ######                  #########            #########         ######
###                  ######         ########################   ###            ###############         #########            ######                  #########            #########         ######
###                                                                           ###############                                                                           ########################
###                                                                           ###############         #########            ######                  #########            ########################
###                  #############################################            ###############         #########            ######                  #########            ########################
################################################################################################################################################################################################
