################################################################################################################################################################################################
##############################               ############         ############         #########         ################################################            ###########################
############            ######               ############         ############                           #########         ##############################            ############            ###
############            ######                                                                                                                     ######                                    ###
############                                                                                                                                                                                 ###
############            ######               ############         ############         #########         #########         ############            ######            ############            ###
############            ###############   ##################   ###############         #########         ############   #################################            ############            ###
###############      ##################   ##################   ###############         #########         ############   ###############################################################   ######
###############      #########            ##################   ###############         #########         ############            ######################################################   ######
###############      #########            ######               ##################   #################################            ##########################################                  ###
############         #########                                 ##################   #################################            ######            ########################                  ###
############         #########            ######               ###############         ######            ############            ######            ########################                  ###
############                                                   ###############                           ############                              #########         ######                  ###
############         #########            ######               ###############                                                   ######            #########                           #########
############         #########            ####################################         ##############################            ######            #########         ###########################
############         #########            ###########################################################################            ###############################################################
##################   ###########################################################################################################################################################################
##################   ###########################################################################################################################################################################
##################            ##############################         #############################################               #####################               ######         ############
######                                                                                                                           #####################                              ############
######   #########            ######                                                         #####################               ###############   ###               ######         ############
######   #########            ######         ###############         #########               #####################               ###############   ###               ######         ############
######   #########   ##################   #####################   ############               ###########################      ##################   #########      ############   ###############
######   #########   ##################   #####################   ###############      #################################      ##################   #########      ############   ###############
######   #########   ##################   #####################   ###############      #################################      ############                        ############   ###############
###                     ###############   ###############            ############      #################################      ############                        ############   ###############
###                     ###############   ###############            ############      #####################                        ######                        #########            #########
###                                                                                                                                 ######                        #########            #########
###                     ############               ######            #########         #####################                        ######                        #########            #########
###                                                                                    #####################                        ######                        #########            #########
###                     ############               ######            #########         #################################   #################################   ##################   ############
###                     #################################            #########         #################################   #################################   ##################   ############
##################   ###################################################################################################   ###############            ######   ###         ######            ###
##################   ###################################################################################################   ###############                  ######         ######            ###
##################   #########            ##############################                           ###############            ############                                                   ###
###                  #########            ######                  ######                           ###############            ############            ############                           ###
###                                       ######                  ######                           ###############            ############            ###############   #########            ###
###                  #########            ######                  ######                           #####################   ##########################################   #########   ############
###                  #########            ######                                             ###########################   ##########################################   #########   ############
###                  #########            ######                  #####################   ##############################   ###############                                                   ###
###                  #########            ###############   ###########################   ###########################         ############                                                   ###
#########   ##################            ###############   ###########################   ###########################         ############                                                   ###
#########   #####################   ############               ########################         #####################         ############                                                   ###
#########   #####################   ############                                                                              ############                                                   ###
###            ############               ######               ########################         #####################         ############                                                   ###
###            ############               #########   #################################   ##############################   ###############                                                   ###
###            ############               #########   #################################   ##############################   ###############                                                   ###
###            ############               #########   #################################   #####################            ###############                                                   ###
###            ##################   ###############   ###########################                  ############            ###############                                                   ###
#########   #####################   ############                           ######                  ############            ###############                                                   ###
#########   #########                     ######                           ######                  ############            ###############                                                   ###
######         ######                     ######                           ######                  ############            ###############                                                   ###
######                                    ######                           ######                  ############            ###############                                                   ###
######         #####################################################################      ########################   #####################                                                   ###
#########   ########################################################################      ########################   #####################                                                   ###
#########   #######################################               ##################      ########################   #########################################################      ############
#########   #######################################               ##################      ########################   #########################################################      ############
###            ######            ##################                                                                                                                                          ###
###                                                                                          ##################               ########################   ############                        ###
###            ######            ##################               ############               ##################               ########################   ############                        ###
#####################            ##################               ############               ##################               ##################                                             ###
###################################################                                          ##################               ##################                                             ###
##############################################################################               ##################               ##################               ######                        ###
################################################################################################################################################################################################
