################################################################
####          ##################################################
####          ############      ##################            ##
####          ############                                    ##
####          ############      ##################            ##
########  ##########################################  ##########
########  ##########################################  ##########
########  ####################        ####            ##########
########  ##      ############        ####            ##########
########  ##      ############                        ##########
############      ############        ####            ##########
############      ############  ##  ######            ##########
############      ############  ##  ############      ##########
##############  ##########          ############      ##########
##############  ##########          ############            ####
######              ######          ############            ####
######                            ##############            ####
######              ######        ################          ####
######              ######        ################          ####
##################################################  ############
##################################################  ############
##############################          ##########  ############
##        ####                                            ######
##                                      ##########  ##      ####
##        ####        ############################  ##      ####
##        ####        ############################  ##      ####
##        ####        ############################  ##      ####
##                                                ####      ####
##        ####        ################################      ####
##        ############################################      ####
##        ############################################      ####
################################################################
