################################################################################################################################################################################################
###         ##################                     ######                  ###########################                              ######                                                   ###
###                                                                        #########         #########                              ######                                                   ###
###                                                                                                                                 ######                                                   ###
######   #####################                     ######                  #########         #########                              ######                                                   ###
######   ####################################   ############   ###########################   #####################   ######   ############                                                   ###
######   ####################################   ############   ###########################   #####################   ######   ############                                                   ###
######   ####################################   ############               ###############   #####################   ######   ############                                                   ###
###               #########                        #########               ############         ######                              ######                                                   ###
###               #########                        #########               ############         ######                              ######                                                   ###
###                                                #########               ############                                             ######                                                   ###
###               #########                        #########               ###########################                              ######                                                   ###
###########################################################################################################################   ############                                                   ###
###########################################################################################################################   ############                                                   ###
###            ############################################################            ####################################   ############                                                   ###
###            ############               #################################            ######                  ######               ######                                                   ###
###            ############               #################################                                                         ######                                                   ###
###            ############               #########         ###############            ######                  ######               #######################################      ###############
###            ############               #########         ##################   ##################   ########################   ##########################################      ###############
#########      ###############   ##################         ##################   ##################   ########################   ##########################################      ###############
#########      ###############   ##################         ##################   ##################   ########################   ##########################################               ######
#########         #########         ###############         ###   ############   ##################   #####################         #######################################               ######
######            #########         ###############         ###   #########               ######            ###############         ###############               #########               ######
#########                           ##################   ######   #########               ######            ###############         ###############                                       ######
#########         #########         ##################   ######   #########               ######            ###############         ###############               #########               ######
############   ###############   #####################   ######   #########                                 ###############         ###############               #########               ######
############   ###############   ###############            ###   #########                                 ###############         #######################################   ##################
############   ###############   ###############                  #########               #################################         #######################################   ##################
#########               ######         #########                  #########               ####################################   ##########################################   ##################
#########               ######         ###############   ###      ############################################################   #################################                     #########
#########               ######         ###############   ###      ############################################################   #########         ###############                     #########
#########               ######         ###############   ###      ############################################################   #########         ###############                     #########
#########                              ###############               ###############         #################################   #########         ###############                     #########
#########                                                                                                                        #########         ###############                     #########
#########               ######                                       ###############         #########                              ######         ###############                     #########
######################################################               ###############         #########               ###            ######         ########################   ###   ############
######################################################   ###########################                                 ###            #########   ###########################   ###   ############
######################################################   ###########################         ##################      ###            #########   ###########################   ###   ############
#######################################            ###   ###########################         ##################      #########   ############   #####################                     ######
#######################################            ###               ###############         ##################      #########   ############   #####################                     ######
############                     ######            ######            ###############         ######                     ######   ############               #########                     ######
#########                                                            ###############   ############                     ######   ############                                             ######
#########                        #########      ############      ##################   ############                     ######   ############               #########                     ######
#########                        #########      ############      ##################   ############                     ######   ##########################################   ######   #########
#########                        #########      ############      #########               #########                     ######   ##########################################   ######   #########
#########   ##############################      ############      #########               ###############   ##################   ##########################################   ###            ###
#########   ##############################      ############      #########               ###############   ##################   ##########################################   ###            ###
#########   ##############################         #########         ######               #########            ######            ############                                                ###
######            ########################         #########                                                                                                                  ###            ###
######                                             #########         ##############################                              #########                                             #########
######            ##########################################         ##############################            ######            #########         ############            #####################
#############################################################################################################################################   ################################################
#############################################################################################################################################   ################################################
##################################################################            ###############################################################   ###########################         ############
###                     ###############   ########################            ######            ##########################################                                          ############
###                                       ########################            ######            ########################   ###############         ########################         ############
###                     ###############   ########################                                                            ############         #############################################
###                     ###############   ########################            ######            ########################      ############         #############################################
###                     ######                        ##############################            ###############                  ###############################################################
###                     ######                                                                                                                                                ##################
###                     ######                        #########################################################                              ###################################################
###                     ######                        #########################################################                  ###############################################################
##############################                        ##########################################################################################################################################
################################################################################################################################################################################################
