################################################################################################################################################################################################
######         #########################################################         ##########################################               ###########################                  #########
######         #########               ###############         #########         ##########################################               ############         ######                  #########
######                                 ###############                                                                                                                                    ######
######         #########               ###############                                                               ######               ############         ######                     ######
#########                                                                                                            #########   ########################   ###########################   ######
#########   ###############   ########################         #########         #########                           #########   ########################   ###########################   ######
#########   ###############   ########################      ###############   ################################################   ########################   ###########################   ######
#########   ###############            ###############      ###############   ################################################   ########################   ###########################   ######
#########   ###############            ############            ############   ################################################   ########################   ###########################   ######
###               #########            ############            #########               ####################################               #########            ######                        ###
###                                    ############                                                                                                            ######                        ###
###               #########            ############            #########               #########            ###############                                                                  ###
###########################            ###############      ############                                    ##################   ###   ############            ######                        ###
###########################            ###############      ############               #########            ##################   ###   #########################################################
###########################   ##################               #########               #########            ##################   ###   #########################################################
###########################   ##################               #########               #########            ##################   ###   ############            #########                     ###
########################            ############               #########               #########            ###############            ############            #########                     ###
###               ######            ############               ############   ##################   ########################                                                                  ###
###               ######            ############               ############   ##################   ########################            ############            #########                     ###
###                                 ############               #########         ###############   ###########################   ###   ############            ############   ###   ############
###               ######            ############               #########                                    ##################   ###   ############            ############   ###   ############
###############   ##############################               #########         ###############   ######   ##################   ###   #####################   #########                     ###
###############   ####################################      ############         ###############   ######   ##################   ###   #####################   #########                     ###
###############   ############            ############      ############         ############                        #########   ###   #####################   #########                     ###
###############   ############            ############      ############         ############                        #########   ###   ##################         ######                     ###
######   ######   ############            #########                                                                  ######               ###############         ######                     ###
###                     ######            #########         ############         ############                        ######               ###############         ######                     ###
###                                       #########         ############         ##########################################               ###############         ######                     ###
###                     ###########################         ############         ###################################################   ##################         ######                     ###
####################################################################################################################################   #########################################################
####################################################################################################################################   #########################################################
#####################               #####################            #########         #############################################   ######         ###########################            ###
#########   #########                                                                  #################################         ###   ######         ############         ######            ###
###                                 #####################            #########         ##################                                             ############                           ###
###                                                            ##################      ##################         ######         ###   ######         ############         ######            ###
###            ######               #############################################      ##################         #########      ###   ######         #################################   ######
######   ###   ######               #############################################      ##################         #########      ###   ######   #######################################   ######
######   ###   ###############   ################################################      ##################         ######               ######   #######################################   ######
######   ###   ###############   ##########################################               ##################   #########               ###            ######         ##################   ######
######   ###   ###############   ##########################################               ##################   #########               ###            ######                                 ###
###            ###############         ####################################               ##################   #########               ###                                                   ###
###                                    #########                     ############      #########               #########               #############################################         ###
###            ###############         #########                     ############      #########            ###############   ######   ################################################   ######
###            ###############         #########                     ############      #########            ###############   ######   ################################################   ######
############   ###############      ###############   ###########################      #########            ############                                                   ############   ######
############   ###############      ###############   ###########################      ##################   ############                                                   ######         ######
############   ###############      ###############   ###########################      ##################   ############                                                   ######         ######
#########               ######      ###############   ###########################      ###############         #########                                                   ######         ######
#########                           ############            ##################            ############         #########                                                   ######         ######
#########               ######                              ##################                                                                                             #########      ######
#########               ######            ######            ##################            ############         #########                                                   #########      ######
#########               ######            ######            ########################   ###############         #########                                                   #########      ######
############   ###############            ##########################################   ##################   ############                                                   ######         ######
############   ###############            ##########################################   ##################   ############                                                   ######         ######
############   ###############   #############################################            ############            ######                                                   ######         ######
############   ###############   #############################################            ############            ######                                                   #########      ######
###               #########            #######################################            ############            ######                                                   #########      ######
###               #########            ###############            ############            ############            ######                                                   ######            ###
###                                                               ############            ############            ######                                                   ######            ###
###               #########            ###############            ####################################            ######                                                                     ###
###                                    ###############            ####################################            ######                                                   ######            ###
###               #########            ###############################################################            ######                                                   ######            ###
################################################################################################################################################################################################
