################################################################################################################################################################################################
################################################################################################         ###############                                                   #########         ###
##########################################   #################################   ###############               #########                                                   #########         ###
##########################################   #################################   ###############         ###   #########                                                   #########         ###
###            ###########################   #################################   ###############         ###   #########                                                   ############   ######
###            ######                              ######               ######   ###############         ###   #########                                                   ############   ######
###                                                ######               ######   ##################   ######   #########                                                   ############   ######
###            ######                                                                                                                                                      ############   ######
#################################   ######   ############               ######   ############                     ######                                                   ############   ######
#################################   ######   ###############   ###############   ############                     ######                                                   #########         ###
#################################   ######   ###############   ###############   ############                     ######                                                   #########         ###
#################################   ######   ############                                                                                                                  #########         ###
#################################   ######   ############                                                         ######                                                   #########         ###
######         ##################                  ######         ############   ############                     ######                                                   #########         ###
######                                             ######         ############   ############                     ######                                                   ############   ######
######         ###   ############                  ######         ############   #######################################                                                   ############   ######
######         ###   ############   ###      #################################   ###########################################################################   ########################   ######
##################   ############   ###      #################################   ###########################################################################   ########################   ######
##################   ############   ###      ###############         #########   ##################               #######################################               #########         ######
##################   ############   ###      ###############         ######            ############               #######################################               #########         ######
##################   ############   ###            #########         ######            ############               ######                  ###############               #########         ######
###############            ######   ###                                                                                                                                                   ######
###############                  ######            #########                                                      ######                  ###############               #########         ######
###############            #################################         ######            ############               #######################################               #########         ######
####################################################################################################################################################################################   #########
####################################################################################################################################################################################   #########
###         ################################################               ###########################            ############                  ###########################                  ###
###                                                                                                                                                                                          ###
###         #########                                                                                                                                                                        ###
###         #########            ############         ######                                                                                       ###         #################################
###         #########            ############         ######               ##################   ################################################################################################
###         #########            ############                              ##################   ################################################################################################
#########   #########            ############         ############   ########################   ##################                     #########         #####################            ######
#########   #########            ############         ############   ########################               ######                                       #####################            ######
###            ###################################################   ########################               ######                     #########         #####################            ######
###            ###################################################   ########################               ######                     #########         ########################   ############
###            #########               #########            ######   ###         ############               #####################   ############         ########################   ############
###            #########                                                         ############               #####################   ###############   ###########################   ############
###            #########                                             ###         ############   ######   #####################         ############   ###########################   ############
###            #########               #########            ######   ########################   ######   #####################         ############   ###########################   ############
###            #########               #########            ######   ##################                  #####################         ######            ############                        ###
###            ####################################   ############   ##################                                                                                                      ###
###            ####################################   ############   ##################                  ############   ######         ######            ############                        ###
###            ####################################   ############               ######                  ############   ###########################   ###########################   ############
#########   #######################################   ############               ######                  ############   ###########################   ###########################   ############
#########   #######################################   ############               ######                  ############   ###########################   #########                        #########
###         #######################################   ############               ######                  #########            #####################   #########                        #########
###         #########                  ############   ############      ###   #########                  #########            #####################   #########                        #########
###         #########                  ############         ######      ###   #########                  #########                              ###   #########                        #########
######      #########                                       ######      ###   ############   #########   #########            #####################   #########                        #########
######      #########                  ############         ######            ############   #########   #########            #####################   #########                        #########
######      #########                  ############         ######            #########         ######   ############   #####################            ######                        #########
######      #######################################      #########            #########         ######   ############   #####################                                          #########
######         ####################################      #########            #########         ######   ############   #####################            ######                        #########
######         ####################################      #########            #########                  ############   ###########################   #########                        #########
######         ####################################      ############   ###############         ###      ############   ###########################   ##########################################
######   ###############                  #########      ############   ###############         ###      ############   ###########################   ##########################################
######   ###############                              ###############   ###########################      ############   ###########################   ##########################################
######   ###############                  ######            #########   ###########################      ############   ###########################   ##########################################
######   #######################################            #########   ###########################      ############                     ######               ##################            ###
###            ###############                              ######               ############               #########                                                                        ###
###            #################################                                 ############                                             ######               ##################            ###
###            ###################################################               ############               #########                     ######               #################################
################################################################################################################################################################################################
